11111111111177111111111111
17777177777177177777177771
17777177777177177777177771
17777177777177177777177771
11111111111111111111111111
17777177177777777177177771
17777177177777777177177771
11111177111177111177111111
77777177777077077777177777
77777177777077077777177777
77777177300400500677177777
77777177077777777077177777
77777177077777777077177777
a000010007777777700010000a
77777177077777777077177777
77777177077777777077177777
77777177000000000077177777
77777177077777777077177777
77777177077777777077177777
11111111111177111111111111
17777177777177177777177771
17777177777177177777177771
11177111111112111111177111
77177177177777777177177177
77177177177777777177177177
11111177111177111177111111
17777777777177177777777771
17777777777177177777777771
11111111111111111111111111
