1117777111
1711411171
1177070711
7111111717
a170770017
710070071a
7177707717
7111211117
7717777177
7711111177