7717777177
7111411117
1177171711
7111111717
a171771117
711177171a
7171111117
1171717711
7111121117
7717777177