7777777777
7111411617
7177171717
7311111757
a171771117
711177171a
7171111117
7171717717
7111121117
7777777777