11111111177111111111
17771777177177717771
11111111111111111111
17771771777717717771
11111771177117711111
77771777077077717777
77771777077077717777
77771770300407717777
77771770777707717777
77771770777707717777
a000100077770001000a
77771770000007717777
77771770777707717777
11111111177111111111
17771777177177717771
11171111112111117111
77171717777771717177
11111711177111711111
17777777177177777771
11111111111111111111